##################################################
#                                                #
# ####################### ###################### #
# ####################### ###################### #
# ####################### ###################### #
# ####################### ###################### #
# ####################### ###################### #
# ####################### ###################### #
# ####################### ###################### #
# ####################### ###################### #
# ####################### ###################### #
# ####################### ###################### #
# ####################### ###################### #
# ####################### ###################### #
#                                                #
# ####################### ###################### #
# ####################### ###################### #
# ####################### ###################### #
# ####################### ###################### #
# ####################### ###################### #
# ####################### ###################### #
# ####################### ###################### #
# ####################### ###################### #
# ####################### ###################### #
# ####################### ###################### #
# ####################### ###################### #
# ####################### ###################### #
# ####################### ###################### #
#                                                #
##################################################